"filename", "language", "C++", "CMake", "comment", "blank", "total"
"/Users/user/Documents/Uczelnia/_4Czwarty Semestr/Silniki do gier/R_Projcet/RayEngine_Project_Minimal/Source/CMakeLists.txt", "CMake", 0, 21, 0, 5, 26
"/Users/user/Documents/Uczelnia/_4Czwarty Semestr/Silniki do gier/R_Projcet/RayEngine_Project_Minimal/Source/Context.h", "C++", 25, 0, 0, 2, 27
"/Users/user/Documents/Uczelnia/_4Czwarty Semestr/Silniki do gier/R_Projcet/RayEngine_Project_Minimal/Source/Game.cpp", "C++", 189, 0, 10, 17, 216
"/Users/user/Documents/Uczelnia/_4Czwarty Semestr/Silniki do gier/R_Projcet/RayEngine_Project_Minimal/Source/Game.h", "C++", 66, 0, 1, 12, 79
"/Users/user/Documents/Uczelnia/_4Czwarty Semestr/Silniki do gier/R_Projcet/RayEngine_Project_Minimal/Source/Game/Component.h", "C++", 23, 0, 0, 3, 26
"/Users/user/Documents/Uczelnia/_4Czwarty Semestr/Silniki do gier/R_Projcet/RayEngine_Project_Minimal/Source/Game/Components/CollisionBehaviorComponent.hpp", "C++", 0, 0, 0, 1, 1
"/Users/user/Documents/Uczelnia/_4Czwarty Semestr/Silniki do gier/R_Projcet/RayEngine_Project_Minimal/Source/Game/Entity.cpp", "C++", 98, 0, 0, 16, 114
"/Users/user/Documents/Uczelnia/_4Czwarty Semestr/Silniki do gier/R_Projcet/RayEngine_Project_Minimal/Source/Game/Entity.h", "C++", 47, 0, 0, 7, 54
"/Users/user/Documents/Uczelnia/_4Czwarty Semestr/Silniki do gier/R_Projcet/RayEngine_Project_Minimal/Source/Game/Level.cpp", "C++", 15, 0, 0, 3, 18
"/Users/user/Documents/Uczelnia/_4Czwarty Semestr/Silniki do gier/R_Projcet/RayEngine_Project_Minimal/Source/Game/Level.h", "C++", 19, 0, 0, 1, 20
"/Users/user/Documents/Uczelnia/_4Czwarty Semestr/Silniki do gier/R_Projcet/RayEngine_Project_Minimal/Source/Game/LevelManager.cpp", "C++", 8, 0, 0, 1, 9
"/Users/user/Documents/Uczelnia/_4Czwarty Semestr/Silniki do gier/R_Projcet/RayEngine_Project_Minimal/Source/Game/LevelManager.h", "C++", 12, 0, 0, 1, 13
"/Users/user/Documents/Uczelnia/_4Czwarty Semestr/Silniki do gier/R_Projcet/RayEngine_Project_Minimal/Source/Game/World.cpp", "C++", 83, 0, 11, 10, 104
"/Users/user/Documents/Uczelnia/_4Czwarty Semestr/Silniki do gier/R_Projcet/RayEngine_Project_Minimal/Source/Game/World.h", "C++", 21, 0, 1, 3, 25
"/Users/user/Documents/Uczelnia/_4Czwarty Semestr/Silniki do gier/R_Projcet/RayEngine_Project_Minimal/Source/Game/WorldManager.cpp", "C++", 8, 0, 0, 2, 10
"/Users/user/Documents/Uczelnia/_4Czwarty Semestr/Silniki do gier/R_Projcet/RayEngine_Project_Minimal/Source/Game/WorldManager.h", "C++", 14, 0, 0, 2, 16
"/Users/user/Documents/Uczelnia/_4Czwarty Semestr/Silniki do gier/R_Projcet/RayEngine_Project_Minimal/Source/Input/Input.cpp", "C++", 41, 0, 0, 5, 46
"/Users/user/Documents/Uczelnia/_4Czwarty Semestr/Silniki do gier/R_Projcet/RayEngine_Project_Minimal/Source/Input/Input.h", "C++", 18, 0, 0, 2, 20
"/Users/user/Documents/Uczelnia/_4Czwarty Semestr/Silniki do gier/R_Projcet/RayEngine_Project_Minimal/Source/Input/InputCodes.h", "C++", 114, 0, 0, 4, 118
"/Users/user/Documents/Uczelnia/_4Czwarty Semestr/Silniki do gier/R_Projcet/RayEngine_Project_Minimal/Source/Main.cpp", "C++", 8, 0, 0, 4, 12
"/Users/user/Documents/Uczelnia/_4Czwarty Semestr/Silniki do gier/R_Projcet/RayEngine_Project_Minimal/Source/MathLib/MathLib.h", "C++", 2, 0, 0, 1, 3
"/Users/user/Documents/Uczelnia/_4Czwarty Semestr/Silniki do gier/R_Projcet/RayEngine_Project_Minimal/Source/MathLib/Vector/VectorOperations.hpp", "C++", 13, 0, 0, 2, 15
"/Users/user/Documents/Uczelnia/_4Czwarty Semestr/Silniki do gier/R_Projcet/RayEngine_Project_Minimal/Source/Physics/Body.cpp", "C++", 152, 0, 0, 13, 165
"/Users/user/Documents/Uczelnia/_4Czwarty Semestr/Silniki do gier/R_Projcet/RayEngine_Project_Minimal/Source/Physics/Body.h", "C++", 52, 0, 6, 9, 67
"/Users/user/Documents/Uczelnia/_4Czwarty Semestr/Silniki do gier/R_Projcet/RayEngine_Project_Minimal/Source/Physics/Shapes.cpp", "C++", 90, 0, 4, 14, 108
"/Users/user/Documents/Uczelnia/_4Czwarty Semestr/Silniki do gier/R_Projcet/RayEngine_Project_Minimal/Source/Physics/Shapes.h", "C++", 57, 0, 0, 5, 62
"/Users/user/Documents/Uczelnia/_4Czwarty Semestr/Silniki do gier/R_Projcet/RayEngine_Project_Minimal/Source/Sources.cmake", "CMake", 0, 50, 0, 11, 61
"/Users/user/Documents/Uczelnia/_4Czwarty Semestr/Silniki do gier/R_Projcet/RayEngine_Project_Minimal/Source/UserGame.hpp", "C++", 52, 0, 0, 3, 55
"/Users/user/Documents/Uczelnia/_4Czwarty Semestr/Silniki do gier/R_Projcet/RayEngine_Project_Minimal/Source/Visuals/AnimatedSprite.cpp", "C++", 67, 0, 0, 6, 73
"/Users/user/Documents/Uczelnia/_4Czwarty Semestr/Silniki do gier/R_Projcet/RayEngine_Project_Minimal/Source/Visuals/AnimatedSprite.h", "C++", 44, 0, 0, 2, 46
"Total", "-", 1338, 71, 33, 167, 1609