"filename", "language", "C++", "CMake", "comment", "blank", "total"
"/Users/user/Documents/Uczelnia/_4Czwarty Semestr/Silniki do gier/R_Projcet/RayEngine_Project_Minimal/Source/CMakeLists.txt", "CMake", 0, 21, 0, 5, 26
"/Users/user/Documents/Uczelnia/_4Czwarty Semestr/Silniki do gier/R_Projcet/RayEngine_Project_Minimal/Source/Game.cpp", "C++", 333, 0, 27, 27, 387
"/Users/user/Documents/Uczelnia/_4Czwarty Semestr/Silniki do gier/R_Projcet/RayEngine_Project_Minimal/Source/Game.h", "C++", 67, 0, 2, 10, 79
"/Users/user/Documents/Uczelnia/_4Czwarty Semestr/Silniki do gier/R_Projcet/RayEngine_Project_Minimal/Source/Input/Input.cpp", "C++", 41, 0, 0, 5, 46
"/Users/user/Documents/Uczelnia/_4Czwarty Semestr/Silniki do gier/R_Projcet/RayEngine_Project_Minimal/Source/Input/Input.h", "C++", 18, 0, 0, 2, 20
"/Users/user/Documents/Uczelnia/_4Czwarty Semestr/Silniki do gier/R_Projcet/RayEngine_Project_Minimal/Source/Input/InputCodes.h", "C++", 114, 0, 0, 4, 118
"/Users/user/Documents/Uczelnia/_4Czwarty Semestr/Silniki do gier/R_Projcet/RayEngine_Project_Minimal/Source/Main.cpp", "C++", 12, 0, 9, 4, 25
"/Users/user/Documents/Uczelnia/_4Czwarty Semestr/Silniki do gier/R_Projcet/RayEngine_Project_Minimal/Source/Physics/Body.cpp", "C++", 56, 0, 0, 10, 66
"/Users/user/Documents/Uczelnia/_4Czwarty Semestr/Silniki do gier/R_Projcet/RayEngine_Project_Minimal/Source/Physics/Body.h", "C++", 28, 0, 0, 4, 32
"/Users/user/Documents/Uczelnia/_4Czwarty Semestr/Silniki do gier/R_Projcet/RayEngine_Project_Minimal/Source/Physics/Shapes.cpp", "C++", 50, 0, 12, 12, 74
"/Users/user/Documents/Uczelnia/_4Czwarty Semestr/Silniki do gier/R_Projcet/RayEngine_Project_Minimal/Source/Physics/Shapes.h", "C++", 51, 0, 0, 5, 56
"/Users/user/Documents/Uczelnia/_4Czwarty Semestr/Silniki do gier/R_Projcet/RayEngine_Project_Minimal/Source/Sources.cmake", "CMake", 0, 27, 0, 6, 33
"/Users/user/Documents/Uczelnia/_4Czwarty Semestr/Silniki do gier/R_Projcet/RayEngine_Project_Minimal/Source/Visuals/AnimatedSprite.cpp", "C++", 67, 0, 0, 6, 73
"/Users/user/Documents/Uczelnia/_4Czwarty Semestr/Silniki do gier/R_Projcet/RayEngine_Project_Minimal/Source/Visuals/AnimatedSprite.h", "C++", 44, 0, 0, 2, 46
"Total", "-", 881, 48, 50, 102, 1081